30
15
111111111111111111111111111111
1                            1
1                            1
1  e                         1
1                            1
1                            1
1                            1
1                            1
1                            1
1                            1
1                            1
1                            1
1                            1
1                            1
11 111111111111111111111111111